0
0
0
0
0
16 6 400,22 6 400
19 21 154 20 2 starting.map
132,132,132,132,132,132,132,132,132,132,132,132,132,132,132,132,132,132,132,132,132,132,132,132,132,132,132,132,132,132,132,132,132,132,132,132,132,132,132,132
132,31,31,31,31,132,31,31,31,31,31,31,31,31,31,31,31,31,31,31,31,31,31,31,31,31,31,31,31,31,31,31,31,31,132,31,31,31,31,132
132,31,31,31,31,132,31,31,31,31,31,31,31,31,31,31,31,31,31,31,31,31,31,31,31,31,31,31,31,31,31,31,31,31,132,31,31,31,31,132
132,132,132,132,31,132,132,132,132,31,31,31,31,31,31,31,31,31,31,31,31,31,31,31,31,31,31,31,31,31,31,132,132,132,132,132,132,132,132,132
132,31,31,31,31,31,31,31,132,31,31,31,31,31,31,31,31,31,31,31,31,31,31,31,31,31,31,31,31,31,31,132,31,31,31,31,31,31,31,132
132,31,31,31,31,31,31,31,132,31,31,31,31,31,31,31,31,31,31,31,31,31,31,31,31,31,31,31,31,31,31,132,31,31,31,31,31,31,31,132
132,31,31,31,31,31,31,31,132,132,132,132,132,31,132,132,132,132,132,132,132,132,132,132,132,31,132,132,132,132,132,132,31,31,31,31,31,31,31,132
132,31,31,31,31,31,31,31,132,132,132,31,31,31,31,31,31,31,31,31,31,31,31,31,31,31,31,31,132,132,132,132,31,31,31,31,31,31,31,132
132,31,31,31,31,31,31,31,132,31,31,31,31,31,31,31,31,31,31,31,31,31,31,31,31,31,31,31,31,31,31,132,31,31,31,31,31,31,31,132
132,31,31,31,31,31,31,31,132,31,31,31,31,31,31,31,31,31,31,31,31,31,31,31,31,31,31,31,31,31,31,132,31,31,31,31,31,31,31,132
132,31,31,31,31,31,31,31,132,31,31,31,31,31,31,31,31,31,31,31,31,31,31,31,31,31,31,31,31,31,31,132,31,31,31,31,31,31,31,132
132,31,31,31,31,31,31,31,132,31,31,31,31,31,31,31,31,31,31,31,31,31,31,31,31,31,31,31,31,31,31,132,31,31,31,31,31,31,31,132
132,31,31,31,31,31,31,31,132,31,31,31,31,31,31,31,31,31,31,31,31,31,31,31,31,31,31,31,31,31,31,132,31,31,31,31,31,31,31,132
132,132,31,132,132,132,132,132,132,31,31,31,31,31,31,31,31,31,31,31,31,31,31,31,31,31,31,31,31,31,31,132,31,31,31,31,31,31,31,132
132,31,31,31,31,31,31,31,31,31,31,31,31,31,31,31,31,31,31,31,31,31,31,31,31,31,31,31,31,31,31,132,31,31,31,31,31,31,31,132
132,31,31,31,31,31,31,31,31,31,31,31,31,31,31,31,31,31,31,31,31,31,31,31,31,31,31,31,31,31,31,132,31,31,31,31,31,31,31,132
132,132,31,132,132,132,132,132,132,31,31,31,31,31,31,31,31,31,31,31,31,31,31,31,31,31,31,31,31,31,31,132,31,31,31,31,31,31,31,132
132,31,31,31,31,31,31,31,132,31,31,31,31,31,31,31,31,31,31,31,31,31,31,31,31,31,31,31,31,31,31,132,31,31,31,31,31,31,31,132
132,31,31,31,31,31,31,31,132,31,31,31,31,31,31,31,31,31,31,31,31,31,31,31,31,31,31,31,31,31,31,31,31,31,31,31,31,31,31,132
132,31,31,31,31,31,31,31,132,31,31,31,31,31,31,31,31,31,31,31,31,31,31,31,31,31,31,31,31,31,31,132,31,31,31,31,31,31,31,132
132,31,31,31,31,31,31,31,132,31,31,31,31,31,31,31,31,31,31,31,31,31,31,31,31,31,31,31,31,31,31,132,31,31,31,31,31,31,31,132
132,132,132,132,132,132,132,132,132,132,132,132,132,132,132,132,31,31,31,31,31,31,31,132,132,132,132,132,132,132,132,132,132,132,132,132,132,132,132,132
