0
0
0
0
0
16 6 400,22 6 400,19 7 402,18 7 403,20 7 404,14 7 405,24 7 405
38 1 154 29 6 top.map,1 1 154 10 6 top.map,19 21 154 20 2 starting.map,20 1 154 19 20 random_dungeon,38 19 150 19 20 random_dungeon,38 15 150 19 20 random_dungeon,38 11 150 19 20 random_dungeon,38 7 150 19 20 random_dungeon
132,132,132,132,132,132,132,132,132,132,132,132,132,132,132,132,132,132,132,132,132,132,132,132,132,132,132,132,132,132,132,132,132,132,132,132,132,132,132,132
132,31,31,31,31,132,31,31,31,31,31,31,31,31,31,31,31,31,31,31,31,31,31,31,31,31,31,31,31,31,31,31,31,31,132,31,31,31,31,132
132,31,31,31,31,132,31,31,31,31,31,31,31,31,31,31,31,31,31,31,31,31,31,31,31,31,31,31,31,31,31,31,31,31,132,31,31,31,31,132
132,132,132,132,31,132,132,132,132,31,31,31,31,31,31,31,31,31,31,31,31,31,31,31,31,31,31,31,31,31,31,132,132,132,132,132,132,132,132,132
132,31,31,31,31,31,31,31,132,31,31,31,31,31,31,31,31,31,31,31,31,31,31,31,31,31,31,31,31,31,31,132,31,31,31,31,31,31,31,132
132,31,31,31,31,31,31,31,132,31,31,31,31,31,31,31,31,31,31,31,31,31,31,31,31,31,31,31,31,31,31,132,31,31,31,132,132,31,132,132
132,31,31,31,31,31,31,31,132,132,132,132,132,31,132,132,132,132,132,132,132,132,132,132,132,31,132,132,132,132,132,132,31,31,31,132,31,31,31,132
132,31,31,31,31,31,31,31,132,132,132,31,31,31,31,31,31,31,31,31,31,31,31,31,31,31,31,31,132,132,132,132,31,31,31,132,31,31,31,132
132,31,31,31,31,31,31,31,132,31,31,31,31,31,31,31,31,31,31,31,31,31,31,31,31,31,31,31,31,31,31,132,31,31,31,132,31,31,31,132
132,31,31,31,31,31,31,31,132,31,31,31,31,31,31,31,31,31,31,31,31,31,31,31,31,31,31,31,31,31,31,132,31,31,31,132,132,132,132,132
132,31,31,31,31,31,31,31,132,31,31,31,31,31,31,31,31,31,31,31,31,31,31,31,31,31,31,31,31,31,31,132,31,31,31,132,31,31,31,132
132,31,31,31,31,31,31,31,132,31,31,31,31,31,31,31,31,31,31,31,31,31,31,31,31,31,31,31,31,31,31,132,31,31,31,31,31,31,31,132
132,31,31,31,31,31,31,31,132,31,31,31,31,31,31,31,31,31,31,31,31,31,31,31,31,31,31,31,31,31,31,132,31,31,31,132,31,31,31,132
132,132,31,132,132,132,132,132,132,31,31,31,31,31,31,31,31,31,31,31,31,31,31,31,31,31,31,31,31,31,31,132,31,31,31,132,132,132,132,132
132,31,31,31,31,31,31,31,31,31,31,31,31,31,31,31,31,31,31,31,31,31,31,31,31,31,31,31,31,31,31,132,31,31,31,132,31,31,31,132
132,31,31,31,31,31,31,31,31,31,31,31,31,31,31,31,31,31,31,31,31,31,31,31,31,31,31,31,31,31,31,132,31,31,31,31,31,31,31,132
132,132,31,132,132,132,132,132,132,31,31,31,31,31,31,31,31,31,31,31,31,31,31,31,31,31,31,31,31,31,31,132,31,31,31,132,31,31,31,132
132,31,31,31,31,31,31,31,132,31,31,31,31,31,31,31,31,31,31,31,31,31,31,31,31,31,31,31,31,31,31,132,31,31,31,132,132,132,132,132
132,31,31,31,31,31,31,31,132,31,31,31,31,31,31,31,31,31,31,31,31,31,31,31,31,31,31,31,31,31,31,31,31,31,31,132,31,31,31,132
132,31,31,31,31,31,31,31,132,31,31,31,31,31,31,31,31,31,31,31,31,31,31,31,31,31,31,31,31,31,31,132,31,31,31,31,31,31,31,132
132,31,31,31,31,31,31,31,132,31,31,31,31,31,31,31,31,31,31,31,31,31,31,31,31,31,31,31,31,31,31,132,31,31,31,132,31,31,31,132
132,132,132,132,132,132,132,132,132,132,132,132,132,132,132,132,132,132,132,31,132,132,132,132,132,132,132,132,132,132,132,132,132,132,132,132,132,132,132,132
