141,141,141,141,141,141,141,141,141,141,141,141,141,141,141,141,141,141,141,141,141,141,141,141,141,141,141,141,141,141,141,141,141,141,141,141,141,141,141,141
141,41,41,41,41,41,141,41,41,41,41,41,41,41,41,41,41,41,41,141,41,41,41,41,41,41,41,41,41,41,41,41,41,41,41,41,41,41,41,141
141,41,41,41,41,41,141,41,41,41,41,41,41,41,41,41,41,41,41,141,41,41,41,41,41,41,41,141,41,41,41,41,41,41,41,41,41,41,41,141
141,41,41,41,41,41,141,41,41,41,41,41,41,41,41,41,41,41,41,141,41,41,41,41,41,41,41,141,141,141,141,141,141,41,141,141,141,141,141,141
141,41,41,41,41,41,41,41,41,41,41,41,41,41,41,41,41,41,41,141,41,41,41,41,41,41,41,141,41,41,41,41,41,41,41,41,41,41,41,141
141,41,41,41,41,41,141,41,41,41,41,41,41,41,41,41,41,41,41,141,41,41,41,41,41,41,41,141,41,41,41,41,41,41,41,41,41,41,41,141
141,41,41,41,41,41,141,41,41,41,41,41,41,41,41,41,41,41,41,141,141,141,141,41,141,141,141,141,41,41,41,41,41,41,41,41,41,41,41,141
141,41,41,41,41,41,141,41,41,41,41,41,41,41,41,41,41,41,41,141,41,41,41,41,41,41,41,141,41,41,41,41,41,41,41,41,41,41,41,141
141,41,41,41,41,41,141,41,41,41,41,41,41,41,41,41,41,41,41,41,41,41,41,41,41,41,41,141,41,41,41,41,41,41,41,41,41,41,41,141
141,41,41,41,41,41,141,41,41,41,41,41,41,41,41,41,41,41,41,141,41,41,41,41,41,41,41,41,41,41,41,41,41,41,41,41,41,41,41,141
141,141,141,41,141,141,141,141,141,141,141,141,141,141,141,41,141,141,141,141,41,41,41,41,41,41,41,141,41,41,41,41,41,41,41,41,41,41,41,141
141,41,41,41,41,41,41,41,41,41,41,141,41,41,41,41,41,41,41,141,41,41,41,41,41,41,41,141,41,41,41,41,41,41,41,41,41,41,41,141
141,41,41,41,41,41,41,41,41,41,41,141,41,41,41,41,41,41,41,141,41,41,41,41,41,41,41,141,41,41,41,41,41,41,41,41,41,41,41,141
141,41,41,41,41,41,41,41,41,41,41,141,41,41,41,41,41,41,41,141,41,41,41,41,41,41,41,141,141,41,141,141,141,141,141,141,141,141,141,141
141,41,41,41,41,41,41,41,41,41,41,141,41,41,41,41,41,41,41,141,41,41,41,41,41,41,41,141,41,41,41,41,41,41,41,41,41,41,41,141
141,41,41,41,41,41,41,41,41,41,41,141,41,41,41,41,41,41,41,141,41,41,41,41,41,41,41,141,41,41,41,41,41,41,41,41,41,41,41,141
141,41,41,41,41,41,41,41,41,41,41,141,41,41,41,41,41,41,41,141,41,41,41,41,41,41,41,141,41,41,41,41,41,41,41,41,41,41,41,141
141,141,141,141,141,141,141,41,141,141,141,141,141,141,141,141,141,141,141,141,41,41,41,41,41,41,41,141,41,41,41,41,41,41,41,41,41,41,41,141
141,41,41,41,41,41,41,41,41,41,41,41,41,41,41,41,41,41,41,141,41,41,41,41,41,41,41,141,41,41,41,41,41,41,41,41,41,41,41,141
141,41,41,41,41,41,41,41,41,41,41,41,41,41,41,41,41,41,41,41,41,41,41,41,41,41,41,41,41,41,41,41,41,41,41,41,41,41,41,141
141,41,41,41,41,41,41,41,41,41,41,41,41,41,41,41,41,41,41,141,41,41,41,41,41,41,41,141,41,41,41,41,41,41,41,41,41,41,41,141
141,141,141,141,141,141,141,141,141,141,141,141,141,141,141,141,141,141,141,141,141,141,141,141,141,141,141,141,141,141,141,141,141,141,141,141,141,141,141,141
