0
0
0
0
starting.map
0 0 0
10 6 154 1 1 castle.map,29 6 154 38 1 castle.map,11 19 150 20 2 random_dungeon
1,1,1,1,1,1,1,1,1,1,1,1,1,1,1,1,1,1,1,1,1,1,1,1,1,1,1,1,1,1,1,1,1,1,1,1,1,1,1,1
1,1,1,1,1,1,1,1,1,1,1,1,1,1,1,1,1,1,1,1,1,1,1,1,1,1,1,1,1,1,1,1,1,1,1,1,1,1,1,1
1,1,1,1,1,1,1,1,1,1,1,1,1,1,1,1,1,1,1,1,1,1,1,1,1,1,1,1,1,1,1,1,1,1,1,1,1,1,1,1
1,1,1,1,1,1,1,1,1,1,1,1,1,1,1,1,1,1,1,1,1,1,1,1,1,1,1,1,1,1,1,1,1,1,1,1,1,1,1,1
1,1,1,1,1,1,1,1,132,132,131,132,132,1,1,1,1,1,1,1,1,1,1,1,1,1,1,132,132,131,132,132,1,1,1,1,1,1,1,1
1,1,1,1,1,1,1,1,132,31,31,31,132,1,1,1,1,1,1,1,1,1,1,1,1,1,1,132,31,31,31,132,1,1,1,1,1,1,1,1
1,1,1,1,1,1,1,1,131,31,31,31,131,1,1,1,1,1,1,1,1,1,1,1,1,1,1,131,31,31,31,131,1,1,1,1,1,1,1,1
1,1,1,1,1,1,1,1,132,31,31,31,132,1,1,1,1,1,1,1,1,1,1,1,1,1,1,132,31,31,31,132,1,1,1,1,1,1,1,1
1,1,1,1,1,1,1,1,132,132,132,31,132,132,132,131,131,132,132,131,131,132,132,131,131,132,132,132,31,132,132,132,1,1,1,1,1,1,1,1
1,1,1,1,1,1,1,1,1,1,132,31,31,31,31,31,31,31,31,31,31,31,31,31,31,31,31,31,31,132,1,1,1,1,1,1,1,1,1,1
1,1,1,1,1,1,1,1,1,1,132,31,31,31,31,31,31,31,31,31,31,31,31,31,31,31,31,31,31,132,1,1,1,1,1,1,1,1,1,1
1,1,1,1,1,1,1,1,1,1,132,31,31,132,132,132,132,132,132,132,132,132,132,132,132,132,132,31,31,132,1,1,1,1,1,1,1,1,1,1
1,1,1,1,1,1,1,1,1,1,131,31,31,132,132,132,132,132,132,132,132,132,132,132,132,132,132,31,31,131,1,1,1,1,1,1,1,1,1,1
1,1,1,1,1,1,1,1,1,1,132,31,31,132,132,132,132,132,132,132,132,132,132,132,132,132,132,31,31,132,1,1,1,1,1,1,1,1,1,1
1,1,1,1,1,1,1,1,1,1,131,31,31,132,132,132,132,132,132,132,132,132,132,132,132,132,132,31,31,131,1,1,1,1,1,1,1,1,1,1
1,1,1,1,1,1,1,1,1,1,132,31,31,132,132,132,132,132,132,132,132,132,132,132,132,132,132,31,31,132,1,1,1,1,1,1,1,1,1,1
1,1,1,1,1,1,1,1,1,1,131,31,31,132,132,132,132,132,132,132,132,132,132,132,132,132,132,31,31,131,1,1,1,1,1,1,1,1,1,1
1,1,1,1,1,1,1,1,1,1,132,31,31,132,132,132,132,132,132,132,132,132,132,132,132,132,132,31,31,132,1,1,1,1,1,1,1,1,1,1
1,1,1,1,1,1,1,1,1,1,131,31,31,132,132,132,132,132,132,132,132,132,132,132,132,132,132,31,31,131,1,1,1,1,1,1,1,1,1,1
1,1,1,1,1,1,1,1,1,1,132,31,31,132,132,132,132,132,132,132,132,132,132,132,132,132,132,31,31,132,1,1,1,1,1,1,1,1,1,1
1,1,1,1,1,1,1,1,1,1,132,132,132,132,132,132,132,132,132,132,132,132,132,132,132,132,132,132,132,132,1,1,1,1,1,1,1,1,1,1
1,1,1,1,1,1,1,1,1,1,132,132,132,132,132,132,132,132,132,132,132,132,132,132,132,132,132,132,132,132,1,1,1,1,1,1,1,1,1,1
