0
starting.map
0
0
0
6 13 406
21 9 155 18 11 small_house.map,19 17 155 18 11 small_house0.map,10 15 155 18 11 small_house1.map,15 7 155 18 11 small_house2.map,7 9 155 18 11 small_house3.map,14 16 155 18 11 small_house4.map,19 13 157 18 11 random_dungeon
10,10,10,10,10,10,10,10,10,10,10,10,10,10,10,10,10,10,10,10,10,10,10,10,10,10,10,10,10,10,10,10,10,10,10,10,10,10,10,10
160,160,161,160,160,160,160,160,160,160,160,160,160,160,160,160,160,160,160,160,160,160,160,160,161,160,160,160,160,160,160,160,160,160,160,160,160,10,1,1
161,160,160,160,160,160,160,160,160,160,160,160,160,160,161,160,160,160,160,160,160,160,160,161,160,160,160,160,160,160,160,160,160,160,161,160,160,10,1,1
160,160,160,143,141,141,10,141,141,141,160,160,160,160,160,160,160,160,160,160,160,160,160,160,160,160,160,160,160,160,160,160,160,160,160,160,160,10,1,1
160,160,160,141,141,156,10,141,141,143,10,10,10,10,10,10,10,10,10,10,10,10,10,10,10,10,10,10,10,10,10,10,10,10,10,10,10,10,1,1
160,160,160,141,141,141,10,156,141,141,1,1,1,1,132,133,132,132,132,132,10,133,132,132,132,133,132,1,1,1,1,1,1,1,1,1,1,1,1,1
160,161,160,10,10,10,10,141,141,141,1,1,1,1,132,132,133,132,132,156,10,132,132,133,132,132,132,1,1,1,1,1,1,1,1,1,1,1,1,1
160,160,160,141,141,141,10,10,10,10,1,1,1,1,132,1,132,132,133,132,10,132,132,156,132,132,133,1,1,1,1,1,1,1,1,1,1,1,1,1
160,160,160,143,141,156,10,141,141,141,1,1,1,10,10,10,10,10,10,10,10,10,10,10,10,10,10,10,1,1,1,1,1,1,1,1,1,1,1,1
160,160,160,141,141,141,10,1,141,143,1,1,1,10,144,156,141,141,142,10,141,1,141,142,132,133,132,10,1,1,1,1,1,1,1,1,1,1,1,1
160,161,160,143,141,143,10,141,141,141,1,1,1,10,141,143,142,141,143,10,141,143,142,144,133,132,132,10,1,1,1,1,1,1,1,1,1,1,1,1
160,160,160,141,141,141,10,141,143,141,1,1,1,10,142,141,141,142,141,10,142,141,141,141,132,133,132,10,1,1,1,1,1,1,1,1,1,1,1,1
160,160,160,141,156,141,10,1,1,1,1,1,1,10,10,10,10,1,1,1,1,1,1,1,133,132,132,10,1,1,1,1,1,1,1,1,1,1,1,1
160,10,10,10,10,10,10,10,10,10,10,10,10,10,133,132,133,1,1,1,1,1,1,1,10,10,10,10,1,1,1,1,1,1,1,1,1,1,1,1
160,10,10,10,10,10,10,10,10,10,10,10,10,10,132,133,132,1,1,1,1,1,1,1,10,10,10,10,10,10,10,10,10,10,10,10,10,10,10,10
160,132,156,132,1,132,156,132,1,132,1,132,1,10,132,132,132,10,142,141,142,10,132,132,133,133,132,10,10,10,10,10,10,10,10,10,10,10,10,10
161,132,132,132,1,132,132,132,1,132,132,132,1,10,1,132,133,10,144,143,142,10,133,133,132,132,132,10,10,10,10,10,10,10,10,10,10,10,10,10
160,132,132,132,1,132,132,132,1,132,132,132,1,10,133,132,132,10,142,1,141,10,132,132,132,156,132,10,1,1,1,1,1,1,1,1,1,1,1,1
160,1,1,1,1,1,1,1,1,1,1,1,1,10,10,10,10,10,10,10,10,10,10,10,10,10,10,10,1,1,1,1,1,1,1,1,1,1,1,1
160,1,1,1,1,1,1,1,1,1,1,1,1,1,1,1,1,1,1,1,1,1,1,1,1,1,1,1,1,1,1,1,1,1,1,1,1,1,1,1
160,1,1,1,1,1,1,1,1,1,1,1,1,1,1,1,1,1,1,1,1,1,1,1,1,1,1,1,1,1,1,1,1,1,1,1,1,1,1,1
160,1,1,1,1,1,1,1,1,1,1,1,1,1,1,1,1,1,1,1,1,1,1,1,1,1,1,1,1,1,1,1,1,1,1,1,1,1,1,1
